..........
.        .
. . .... .
... . B. .
  . .  . .   
. .    . .
. ...... .
.        .
.        .
.... .....