.... .....
.R      R.
.  ..... .
.  .RRR  .
   .        
.  .RR.. .
.  . RC. .
.  ..... .
.R      R.
.... .....