.... .....
.R      R.
.  R  R  .
.   RR   .
            
.        .
.   RR   .
.  R   R .
. R     R.
.... .....