.... .....
.        .
.        .
....d.....
            
....d.....
.        .
.        .
.        .
.... .....