.... .....
.        .
.        .
.    .S  .
     C.      
.        .
.  .C    .
.  S.    .
.        .
.... .....