.... .....
. R    . .
.        .
.  O   O .
            
.  .     .
.  O   O .
.     .  .
. R  T   .
.... .....