.... .....
.        .
.        .
. .. ... .
  . d  .    
. ...... .
.        .
.        .
.        .
.... .....