.... .....
.        .
.   R    .
.  ...   .
    .        
.   .    .
.   .    .
. R .  R .
.        .
.... .....