.... .....
.CR      .
....    ..
.        .
            
.        .
.        .
.     ....
.      RC.
.... .....