.... .....
.C      C.
.TTTTTTTT.
....  ....
            
.        .
.        .
.        .
.        .
.... .....