.... .....
.... .....
... T ....
...    ...
  T  С T       
...    ...
...   ....
....T.....
.... .....
.... .....