.... .....
.        .
. ...... .
. . CC . .
  SSSSSS    
. ...... .
. .    . .
. .    . .
.        .
.... .....