.... .....
.        .
.     O  .
.        .
            
.        .
.        .
.  O     .
.        .
.... .....