.... .....
.        .
.        .
.    d   .
    dCd      
.    d   .
.        .
.        .
.        .
.... .....