.... .....
.        .
.        .
.  D.D   .
   ...        
.   .    .
.   .    .
.        .
.        .
.... .....