.... .....
.        .
.  ....  .
.  OCCO  .
   OTTO       
.  ....  .
.        .
.     R  .
.  R     .
.... .....