.... .....
.        .
. . SS . .
. . RR . .
  . OO .    
.  ....  .
.  S..S  .
.  O..T  .
.U      U.
.... .....